111111111111111111
1P1010000001E10001
10000C000001010111
100000000000C10001
111111111111111111