111111111111111111
1P1010001M00E10001
10000C101001C10111
100010M00001C10001
111111111111111111